###############
#             #
#I            #
########### ###
    ####### #  
   ##       #  
   #  #######  
 ### ########  
 #            O
##########  ###
###############