###############
#I            #
############# #
#             #
# #############
#             #
#########   # #
############# #
#O            #
###############